5 10
|--------|
|FFF|....|
|FF-|.@..|
|..F.....|
|--------|