6 10
|--------|
|FFF|....|
|........|
|FF...@|.|
|..F...|.|
|--------|