5 10
|--------|
|....FF..|
|@P.FFFFF|
|....FFFF|
|--------|